#Example: Most human kingdoms
mild_winter = {
	382 28 68 65 67 66 162 164 165 166 167 169 170 173 171 168
	29 430 30 31 36 37 34 38 8 39 40 267 268 41 42 265 266 264 269
	43 270 48 11 62 60 61 53 534 55 54 535 52 50 51 57 58 56 
	442 443 444 64 63 309 566 567 568 12 569 570 308 573 574
	571 307 572 14 59 15 6 4 5 7 219 218 220 1 221 222 223
	10 9 79 278 19 303 304 3 271 272 16 276 277 17 273 274
	275 18 20 520 522 521 524 523 525 526 528 527 180 181 
	179 182 183 198 199 200 201 175 476 477 478 177 176 479
	178 480 196 197 195 225 208 563 564 562 561 560 558
	557 559 203 202 234 233 229 209 230 231 235 207 205 206 204
	224 227 232 255 254 237 240 236 243 238 239 241 280 279
}

#Example: Mountains & Fremennik Provs
normal_winter = {
	32 33 481 482 35 47 388 383 13 305 306 228 226 253 184 188
	189 194 190 191 185 186 187 343 344 346 347 348 350
	351 352 353 
}

#Example: Trollweiss Mountains & Iceberg
severe_winter = {
	575 576 577 578 579 345 349 354 355 356 357 358 335
	336 337 338 417 418 339 419 420 192 340 455 158
}
